com.trinitigame.callofminibulletdudes.a1	Beginner's Luck	Complete any stage without getting hurt.	2
com.trinitigame.callofminibulletdudes.a2	Weekend Warrior	 Kill 1000 zombies.	5
com.trinitigame.callofminibulletdudes.a3	XXX	 XXX	1
com.trinitigame.callofminibulletdudes.a4	Bionic Man	Gain 1 X-800 set.	10
com.trinitigame.callofminibulletdudes.a5	Cyclone	Gain 1 Ninja set.	5
com.trinitigame.callofminibulletdudes.a6	Brawler	Gain 1 Zombie Buster.	5
com.trinitigame.callofminibulletdudes.a7	Immortality	Use one Epinephrine.	2
com.trinitigame.callofminibulletdudes.a8	Zombie Slayer	Kill 10000 zombies.	15
com.trinitigame.callofminibulletdudes.a9	Partial Clearance	Complete the first map.	20
com.trinitigame.callofminibulletdudes.a10	Stage Victory	Complete the second map.	20
com.trinitigame.callofminibulletdudes.a11	Popcorn	Take damage from 100 Gasbombs.	10
com.trinitigame.callofminibulletdudes.a12	Indomitable	Die 99 times.	5
com.trinitigame.callofminibulletdudes.a13	Advance	 Unlock the second map.	3
com.trinitigame.callofminibulletdudes.a14	Inside Man	Gain 1 Zombie Assassin.	5
com.trinitigame.callofminibulletdudes.a15	Fireworks	Gain 1 Multirocket.	10
com.trinitigame.callofminibulletdudes.a16	Heavy Fire	Gain 1 Volcano.	10
com.trinitigame.callofminibulletdudes.a17	Savior	 Gain 1 Hacker set.	3
com.trinitigame.callofminibulletdudes.a18	Hardcore	Gain 1 Death Squads set.	5
com.trinitigame.callofminibulletdudes.a19	Strength and Honor	Gain 1 Gladiator set.	5
com.trinitigame.callofminibulletdudes.a20	Pandora's Box	Make your first in-app purchase.	5
com.trinitigame.callofminibulletdudes.a21	Arms Dealer	Spend $49.99 total.	25
com.trinitigame.callofminibulletdudes.a22	Lord of War	 Spend $99.99 total.	25
com.trinitigame.callofminibulletdudes.a23	 Ionic Man	 Gain 1 Massacre Cannon.	15
com.trinitigame.callofminibulletdudes.a24	Skillful Fighter	Can't Touch This: Complete 20 consecutive perfect waves.	10
com.trinitigame.callofminibulletdudes.a25	No Man Left Behind	 Protect your ally from dying for 20 consecutive waves.	5
com.trinitigame.callofminibulletdudes.a26	First Meeting	 Use a friend's character as your ally in battle.	2
com.trinitigame.callofminibulletdudes.a27	Negligent	Allow your ally to die 200 times.	10
com.trinitigame.callofminibulletdudes.a28	Perseverance	Login 7 days in a row and claim your reward.	5
com.trinitigame.callofminibulletdudes.a29	Hired Guns	IInvite 100 friends into the game and have each friend complete one battle.	10
com.trinitigame.callofminibulletdudes.a30	Expendable	Reach level 10.	5
com.trinitigame.callofminibulletdudes.a31	Commando	 Reach level 30.	5
com.trinitigame.callofminibulletdudes.a32	Veteran	 Reach level 50.	5
com.trinitigame.callofminibulletdudes.a33	Grinder	Reach level 100.	10
com.trinitigame.callofminibulletdudes.a34	Cremation Stove	Reach level 150.	20
com.trinitigame.callofminibulletdudes.a35	Cross Hell	Reach level 200.	20
com.trinitigame.callofminibulletdudes.a36	OVERMIND	Reach level 255.	50
com.trinitigame.callofminibulletdudes.a37	Beginner's Luck	Use one Epinephrine.	2
com.trinitigame.callofminibulletdudes.a38	Rookie of the Year	Kill 10000 zombies.	15
com.trinitigame.callofminibulletdudes.a39	Battleholic	Complete the first map.	20
com.trinitigame.callofminibulletdudes.a40	Known 2 Pwn	Complete the second map.	20
com.trinitigame.callofminibulletdudes.a41	Living Legend	Take damage from 100 Gasbombs.	10
com.trinitigame.callofminibulletdudes.a42	Serial Killer	Die 99 times.	5
com.trinitigame.callofminibulletdudes.a43	Mass Murderer	 Unlock the second map.	3
com.trinitigame.callofminibulletdudes.a44	Homicidal Maniac	Gain 1 Zombie Assassin.	5
com.trinitigame.callofminibulletdudes.a45	Genocidal Maniac	Gain 1 Multirocket.	10
com.trinitigame.callofminibulletdudes.a46	Threat to the Species	Gain 1 Volcano.	10
com.trinitigame.callofminibulletdudes.a47	Double Play	 Gain 1 Hacker set.	3
com.trinitigame.callofminibulletdudes.a48	Triple Threat	Gain 1 Death Squads set.	5
com.trinitigame.callofminibulletdudes.a49	Killer Quads	Gain 1 Gladiator set.	5
com.trinitigame.callofminibulletdudes.a50	Mega Merciless	Make your first in-app purchase.	5
com.trinitigame.callofminibulletdudes.a51	Full-time Killer	Spend $49.99 total.	25
com.trinitigame.callofminibulletdudes.a52	Bullet Repellant	 Spend $99.99 total.	25
com.trinitigame.callofminibulletdudes.a53	Clay Pigeon	 Gain 1 Massacre Cannon.	15
com.trinitigame.callofminibulletdudes.a54	Money Ain't a Thing	Can't Touch This: Complete 20 consecutive perfect waves.	10
com.trinitigame.callofminibulletdudes.a55	Too Fit to Quit	 Protect your ally from dying for 20 consecutive waves.	5
com.trinitigame.callofminibulletdudes.a56	I Hate That Guy	 Use a friend's character as your ally in battle.	2
com.trinitigame.callofminibulletdudes.a57	Killasaurus Rex	Allow your ally to die 200 times.	10
com.trinitigame.callofminibulletdudes.a58	Master of Disguise	Login 7 days in a row and claim your reward.	5
com.trinitigame.callofminibulletdudes.a59	Shadow Warrior	IInvite 100 friends into the game and have each friend complete one battle.	10
com.trinitigame.callofminibulletdudes.a60	Skills to Get the Kills	Reach level 10.	5

